XXXXXXXXXXX
XS  X XG  X
X XXX XXX X
X         X
XXXXXXXXXXX
XXXXXXXXXXX