XXXXXXXXXXXXXXXXXXXXXXXXXXXXXXXXXXXXXXXXX
XSX X X X X X X X     X X X       X     X
X X X X X X X X X XXXXX X X XXXXXXX XXX X
X           X X           X   X X X X X X
X X X XXX X X X XXXXX XXX X XXX X X X X X
X X X   X X         X   X   X X       X X
X X X XXX X XXX X XXXXXXXXXXX X X X XXX X
X X X X   X   X X         X     X X X X X
X XXXXXXXXX X X X X XXX XXX XXX XXXXX X X
X X X X   X X X X X   X       X       X X
X X X X XXXXXXXXX XXXXX X X X X X X XXX X
X         X X   X     X X X X X X X   XGX
X X XXXXXXX X XXXXX X XXX XXXXXXX XXX XXX
X X               X X   X   X   X   X X X
X X XXXXXXXXX X X XXX X XXX X X XXXXXXX X
X X       X   X X   X X X     X         X
XXX X XXX XXX X X XXXXXXXXX X X XXXXXXXXX
X   X   X X   X X   X       X X         X
X X XXXXX X XXX XXX XXX X XXX X XXX X X X
X X     X X X     X X   X X   X   X X X X
XXXXXXXXXXXXXXXXXXXXXXXXXXXXXXXXXXXXXXXXX