XXXXXXXXXXXXXXXXXXXXXXXXXXXXXXXXXXXXXXXXXXXXXXXXXXXXXXXXXXXXX
XS  X     X X       X       X X   X X X X   X   X     X     X
X X XXX XXX X X X XXX XXXXXXX X XXX X X XXX X XXX XXXXX XXXXX
X X       X X X X X     X         X   X X X                 X
XXX XXXXX X X XXXXX XXXXX XXXXXXXXX XXX X X XXX X XXXXXXXXX X
X       X           X X   X X       X X X     X X X X     X X
X XXX XXXXX XXXXXXX X XXX X X XXXXXXX X X X X X X X X X XXXXX
X   X X         X         X     X         X X X X X   X X X X
X XXX XXX X XXX XXXXXXXXXXX XXXXX XXXXXXX X XXXXX X XXXXX X X
X   X X   X   X                         X X   X     X       X
X XXX XXX X XXXXXXX X X XXX X XXXXXXX X XXX XXXXX X X XXXXX X
X X   X   X       X X X X   X     X   X   X   X   X X     X X
XXXXXXX XXXXX XXX X X X XXX XXX XXXXXXX XXXXXXXXX XXX XXX X X
X         X     X X X X   X   X X   X           X       X X X
X X X X XXXXX XXX XXX X XXX XXXXX XXXXX X XXX XXX X X XXX XXX
X X X X     X   X   X X X         X     X   X   X X X   XGX X
X X XXXXX X XXXXX XXX XXX X XXX XXXXX X X XXXXXXX XXXXXXXXX X
X X X X X X     X   X X   X   X X X X X X X     X         X X
X XXX X X XXXXXXX X XXXXX XXXXXXX X XXX X X XXXXX XXXXX X X X
X X             X X X   X           X   X   X   X   X   X   X
XXXXXXX XXXXXXXXX XXX X X X X X XXXXX XXX X X XXXXXXXXXXX XXX
X             X       X X X X X     X X   X         X   X   X
X X XXX X X X XXXXXXXXXXX XXX X X X XXXXXXX X XXXXXXX XXX XXX
X X X   X X X     X X     X X X X X     X   X   X   X X   X X
X XXX X XXXXX X XXX X XXX X XXX X X X XXXXXXX XXX XXX XXXXX X
X   X X   X   X     X X       X X X X X             X X X   X
X XXX XXX XXX X X XXXXXXX X XXX XXXXX XXXXX X X XXX X X XXX X
X X     X   X X X X   X   X   X     X   X   X X X X X       X
X XXX XXX X X XXXXX XXX XXX XXXXXXX X XXX X XXX X XXX XXXXX X
X X     X X X X         X         X X X   X X             X X
XXXXXXXXXXXXXXXXXXXXXXXXXXXXXXXXXXXXXXXXXXXXXXXXXXXXXXXXXXXXX